// Chicken
######
#    #
# #@ #
# .* #
# $* #
#    #
######
